//MAP CONVERTED BY dmm2tgm.py THIS HEADER COMMENT PREVENTS RECONVERSION, DO NOT REMOVE
"aR" = (
/turf/open/floor/plasteel/f13/vault_floor/blue/side{
	dir = 10
	},
/area/shuttle/escape)
"ba" = (
/turf/open/floor/plasteel/f13/vault_floor/blue/side{
	dir = 4
	},
/area/shuttle/escape)
"bw" = (
/turf/open/floor/plasteel/f13/vault_floor/blue,
/area/shuttle/escape)
"cl" = (
/obj/structure/table/reinforced,
/turf/open/floor/plasteel/f13/vault_floor/blue/whitebluefull,
/area/shuttle/escape)
"ds" = (
/obj/machinery/light{
	dir = 4
	},
/turf/open/floor/plasteel/f13/vault_floor/floor,
/area/shuttle/escape)
"ez" = (
/obj/structure/window/fulltile/store{
	icon_state = "storewindowright"
	},
/turf/open/floor/plasteel/f13/vault_floor/floor/floorsolid,
/area/shuttle/escape)
"fh" = (
/obj/structure/railing{
	dir = 9
	},
/turf/open/floor/plasteel/f13/vault_floor/dark,
/area/shuttle/escape)
"ku" = (
/obj/structure/chair/booth{
	dir = 1
	},
/obj/machinery/light{
	dir = 4
	},
/turf/open/floor/plasteel/f13/vault_floor/blue/whitebluefull,
/area/shuttle/escape)
"lT" = (
/turf/open/floor/plasteel/f13/vault_floor/blue/side{
	dir = 9
	},
/area/shuttle/escape)
"mi" = (
/obj/structure/window/fulltile/store{
	icon_state = "storewindowvertical"
	},
/turf/open/floor/plasteel/f13/vault_floor/floor/floorsolid,
/area/shuttle/escape)
"pc" = (
/obj/structure/window/fulltile/store,
/turf/open/floor/plasteel/f13/vault_floor/floor/floorsolid,
/area/shuttle/escape)
"qy" = (
/obj/structure/window/fulltile/store{
	icon_state = "storewindowbottom"
	},
/turf/open/floor/plasteel/f13/vault_floor/floor/floorsolid,
/area/shuttle/escape)
"rx" = (
/obj/structure/chair/booth{
	dir = 1
	},
/obj/machinery/light{
	dir = 8
	},
/turf/open/floor/plasteel/f13/vault_floor/blue/whitebluefull,
/area/shuttle/escape)
"vv" = (
/turf/open/floor/plasteel/f13/vault_floor/blue/side{
	dir = 1
	},
/area/shuttle/escape)
"wh" = (
/obj/machinery/computer/emergency_shuttle{
	desc = "For train control.";
	dir = 1;
	name = "train controls"
	},
/turf/open/floor/plasteel/f13/vault_floor/blue/whitebluefull,
/area/shuttle/escape)
"wX" = (
/turf/template_noop,
/area/template_noop)
"xG" = (
/obj/structure/chair/booth,
/obj/machinery/light{
	dir = 8
	},
/turf/open/floor/plasteel/f13/vault_floor/blue/whitebluefull,
/area/shuttle/escape)
"zD" = (
/obj/structure/chair/booth,
/turf/open/floor/plasteel/f13/vault_floor/blue/whitebluefull,
/area/shuttle/escape)
"Bf" = (
/obj/docking_port/mobile/emergency{
	dwidth = 24;
	height = 6;
	name = "Vault emergency shuttle";
	width = 25
	},
/turf/closed/wall,
/area/shuttle/escape)
"Cx" = (
/obj/machinery/light{
	dir = 4
	},
/turf/open/floor/plasteel/f13/vault_floor/blue/side{
	dir = 9
	},
/area/shuttle/escape)
"EU" = (
/obj/structure/chair/booth{
	dir = 1
	},
/turf/open/floor/plasteel/f13/vault_floor/blue/whitebluefull,
/area/shuttle/escape)
"Hs" = (
/turf/open/floor/plasteel/f13/vault_floor/blue/side{
	dir = 6
	},
/area/shuttle/escape)
"HG" = (
/obj/machinery/light{
	dir = 8
	},
/turf/open/floor/plasteel/f13/vault_floor/blue/side{
	dir = 5
	},
/area/shuttle/escape)
"Iz" = (
/turf/closed/wall,
/area/shuttle/escape)
"Jc" = (
/obj/machinery/door/airlock/grunge,
/turf/open/floor/plasteel/f13/vault_floor/blue/whitebluefull,
/area/shuttle/escape)
"KS" = (
/turf/open/floor/plasteel/f13/vault_floor/blue/side,
/area/shuttle/escape)
"Mj" = (
/obj/structure/railing{
	dir = 1
	},
/turf/open/floor/plasteel/f13/vault_floor/dark,
/area/shuttle/escape)
"MI" = (
/obj/machinery/door/airlock/grunge,
/obj/structure/fans/tiny/invisible,
/turf/open/floor/plasteel/f13/vault_floor/blue/whitebluefull,
/area/shuttle/escape)
"MN" = (
/obj/structure/window/fulltile/store{
	icon_state = "storewindowleft"
	},
/turf/open/floor/plasteel/f13/vault_floor/floor/floorsolid,
/area/shuttle/escape)
"OC" = (
/obj/machinery/light{
	dir = 4
	},
/turf/open/floor/plasteel/f13/vault_floor/blue/side{
	dir = 4
	},
/area/shuttle/escape)
"Qr" = (
/obj/structure/chair/office/dark,
/turf/open/floor/plasteel/f13/vault_floor/blue/side,
/area/shuttle/escape)
"SH" = (
/obj/structure/railing{
	dir = 5
	},
/turf/open/floor/plasteel/f13/vault_floor/dark,
/area/shuttle/escape)
"SV" = (
/turf/open/floor/plasteel/f13/vault_floor/floor,
/area/shuttle/escape)
"Ul" = (
/turf/open/floor/plasteel/f13/vault_floor/blue/side{
	dir = 5
	},
/area/shuttle/escape)
"Um" = (
/obj/structure/chair/booth,
/obj/machinery/light{
	dir = 4
	},
/turf/open/floor/plasteel/f13/vault_floor/blue/whitebluefull,
/area/shuttle/escape)
"WL" = (
/obj/structure/window/fulltile/store{
	icon_state = "storewindowvertical"
	},
/turf/open/floor/plasteel/f13/vault_floor/blue/whitebluefull,
/area/shuttle/escape)
"WV" = (
/turf/open/floor/plasteel/f13/vault_floor/blue/side{
	dir = 8
	},
/area/shuttle/escape)
"Xe" = (
/obj/machinery/light{
	dir = 8
	},
/turf/open/floor/plasteel/f13/vault_floor/blue/side{
	dir = 8
	},
/area/shuttle/escape)
"Yf" = (
/obj/machinery/light{
	dir = 8
	},
/turf/open/floor/plasteel/f13/vault_floor/floor,
/area/shuttle/escape)

(1,1,1) = {"
fh
Iz
MI
Iz
WL
Iz
WL
Iz
WL
Iz
WL
Iz
MI
Iz
wX
Iz
MI
Iz
mi
Iz
mi
Iz
mi
Iz
mi
Iz
MI
Iz
wX
Iz
MI
Iz
mi
Iz
mi
Iz
mi
Iz
mi
Iz
MI
Iz
wX
Iz
Iz
Iz
Iz
Iz
Iz
MI
qy
Bf
"}
(2,1,1) = {"
Mj
Iz
Ul
xG
WV
zD
WV
xG
WV
zD
WV
xG
aR
Iz
WL
Iz
Ul
xG
WV
zD
WV
xG
WV
zD
WV
xG
aR
Iz
WL
Iz
Ul
xG
WV
EU
zD
Yf
EU
zD
WV
rx
aR
Iz
WL
Iz
Ul
Xe
aR
Iz
HG
aR
cl
MN
"}
(3,1,1) = {"
Mj
MI
vv
SV
SV
SV
SV
SV
SV
SV
SV
SV
KS
Jc
bw
Jc
vv
SV
SV
SV
SV
SV
SV
SV
SV
SV
KS
Jc
bw
Jc
vv
SV
SV
SV
SV
SV
SV
SV
SV
SV
KS
Jc
bw
Jc
vv
SV
KS
Jc
vv
Qr
wh
pc
"}
(4,1,1) = {"
Mj
Iz
lT
Um
ba
zD
ba
Um
ba
zD
ba
Um
Hs
Iz
WL
Iz
lT
Um
ba
zD
ba
Um
ba
zD
ba
Um
Hs
Iz
WL
Iz
lT
Um
ba
EU
zD
ds
EU
zD
ba
ku
Hs
Iz
WL
Iz
lT
OC
Hs
Iz
Cx
Hs
cl
ez
"}
(5,1,1) = {"
SH
Iz
MI
Iz
WL
Iz
WL
Iz
WL
Iz
WL
Iz
MI
Iz
wX
Iz
MI
Iz
WL
Iz
WL
Iz
WL
Iz
WL
Iz
MI
Iz
wX
Iz
MI
Iz
WL
Iz
WL
Iz
WL
Iz
WL
Iz
MI
Iz
wX
Iz
Iz
Iz
Iz
Iz
Iz
MI
qy
Iz
"}
