//MAP CONVERTED BY dmm2tgm.py THIS HEADER COMMENT PREVENTS RECONVERSION, DO NOT REMOVE
"a" = (
/obj/effect/turf_decal/stripes/white/line{
	dir = 6
	},
/turf/open/floor/plasteel/f13/vault_floor/floor/floorsolid,
/area/shuttle/northbunker_elevator)
"c" = (
/obj/effect/turf_decal/stripes/white/line{
	dir = 1
	},
/turf/open/floor/plasteel/f13/vault_floor/floor/floorsolid,
/area/shuttle/northbunker_elevator)
"d" = (
/obj/effect/turf_decal/stripes/white/line{
	dir = 5
	},
/turf/open/floor/plasteel/f13/vault_floor/floor/floorsolid,
/area/shuttle/northbunker_elevator)
"e" = (
/obj/effect/turf_decal/stripes/white/line,
/turf/open/floor/plasteel/f13/vault_floor/floor/floorsolid,
/area/shuttle/northbunker_elevator)
"o" = (
/turf/open/floor/plasteel/f13/vault_floor/floor,
/area/shuttle/northbunker_elevator)
"s" = (
/obj/effect/turf_decal/stripes/white/line{
	dir = 8
	},
/turf/open/floor/plasteel/f13/vault_floor/floor/floorsolid,
/area/shuttle/northbunker_elevator)
"G" = (
/obj/effect/turf_decal/stripes/white/line{
	dir = 9
	},
/turf/open/floor/plasteel/f13/vault_floor/floor/floorsolid,
/area/shuttle/northbunker_elevator)
"K" = (
/obj/structure/chair{
	dir = 1
	},
/turf/open/floor/plasteel/f13/vault_floor/floor,
/area/shuttle/northbunker_elevator)
"M" = (
/obj/structure/chair{
	dir = 4
	},
/turf/open/floor/plasteel/f13/vault_floor/floor,
/area/shuttle/northbunker_elevator)
"R" = (
/turf/open/floor/plasteel/f13/vault_floor/floor/floorsolid,
/area/shuttle/northbunker_elevator)
"V" = (
/obj/machinery/computer/shuttle/northbunkerelevator{
	dir = 8
	},
/turf/open/floor/plasteel/f13/vault_floor/floor,
/area/shuttle/northbunker_elevator)
"W" = (
/obj/docking_port/mobile/elevator{
	dheight = 0;
	dir = 8;
	dwidth = 1;
	height = 3;
	id = "northbunker_elevator";
	name = "north bunker elevator";
	width = 4
	},
/obj/effect/turf_decal/stripes/white/line{
	dir = 4
	},
/turf/open/floor/plasteel/f13/vault_floor/floor/floorsolid,
/area/shuttle/northbunker_elevator)
"X" = (
/obj/effect/turf_decal/stripes/white/line{
	dir = 10
	},
/turf/open/floor/plasteel/f13/vault_floor/floor/floorsolid,
/area/shuttle/northbunker_elevator)

(1,1,1) = {"
o
a
s
d
K
"}
(2,1,1) = {"
o
c
R
e
K
"}
(3,1,1) = {"
M
c
R
e
K
"}
(4,1,1) = {"
V
X
W
G
K
"}
